F assets/textures/grass.xpm
C assets/textures/sky_tramonto.xpm

NO assets/textures/north.xpm
SO assets/textures/south.xpm
WE assets/textures/west.xpm
EA assets/textures/east.xpm
F 220,100,0
C 225,30,0

11111111111111111111111111111111111111111
10000000001000000000000000000000000000001
10000000001000000000000000000000000000001
10000000001000000000000000000000000000001
10000000000000000000000000000000000000001
10000000000000000000000000000000000000001
10000000000000000000111111111111000000001
10000000000000000000100000000001000000001
10000000000000000000100000000001000000001
10000000000000000000100000000001000000001
10000000000000000000100000000001000000001
10000000000000000000100000N00001000000001
10000000000000000000100000000001000000001
10000000000000000000100000000001000000001
10000000000000000000100000000001000000001
10000000000000000000111111111111000000001
10000000000000000000000000000000000000001
10000000000000000000000000000000000000001
10000000000000000000000000000000000000001
10001111111100000000000000000000000000001
10001000000100000000000000000000000000001
10001000000100000000000000000000000000001
10001000000100000000000000000000000000001
10001111111100000000000000000000000000001
10000000000000000000000000000000000000001
10000000000000000000000000000000000000001
10000000000000000000000000000000000000001
10000000000000000000000000000000000000001
10000000000000000000000000000000000000001
11111111111111111111111111111111111111111
