F assets/textures/grass.xpm
C assets/textures/sky_tramonto.xpm

NO assets/textures/north.xpm
SO assets/textures/south.xpm
WE assets/textures/west.xpm
EA assets/textures/east.xpm
F 160,82,45
C 135,206,235

1111111111111111111111111111111
1000100000100000100000100000001
1010101110101110101110101110101
1010000000000010000000000010001
1011111111111011111111111011101
1000000000001000000000001000001
1111101111101111101111101111101
1000001000000000001000000000001
1011101011111111101011111111101
1010001010000000001010000000001
1010111010111111111010111111101
1010000010100000000010100000001
1011111110101111111110101111111
1000000000101000000000101000001
1111111111101011111111101011101
1000000000001010000000001010001
1011111111111010111111111010101
1010000000000010100000000010101
1010111111111110101111111110101
1010100000000000101000000000101
1010101111111111101011111111101
1010001000000000001010000000001
1011101011111111111010111111101
1000101000000000000010100000001
1110101111111111111110101111111
1000100000000000000000101000001
1010111111111111111111101011101
1010000000000000000000001010001
1011111111111111111111111010101
100000000000000N0000000000010001
1111111111111111111111111111111
